footballs=football
fish=fish
picks=pick
carrots=carrot
bananas=banana
barbarian axes=barbarian axe
torches=torch
skull staffs=skull staff
sandals=sandals
bags=bag
scale armors=scale armor
noble armors=noble armor
spears=spear
breads=bread
small stones=small stone
cherries=cherry
steel boots=steel boots
thunder hammers=thunder hammer
ropes=rope
traps=trap
demon helmets=demon helmet
spike swords=spike sword
warlord swords=warlord sword
ruby necklaces=ruby necklace
scarfs=scarf
amazon shields=amazon shield
shields of honour=shield of honour
snowballs=snowball
vials of lifefluid=vial of lifefluid
ankhs=ankh
life crystals=life crystal
knight axes=knight axe
orcish axes=orcish axe
naginatas=naginata
war hammers=war hammer
staffs=staff
clerical maces=clerical mace
crystal maces=crystal mace
throwing knives=throwing knife
power bolts=power bolt
spellbooks=spellbook
cookies=cookie
wands of might=wand of might
yellow spell wands=yellow spell wand
vials of beer=vial of beer
crystal coins=crystal coin
small rubies=small ruby
small diamonds=small diamond
wooden keys=wooden key
tomatoes=tomato
vials of blood=vial of blood
presents=present
golden keys=golden key
bone keys=bone key
worms=worm
white pearls=white pearl
vials of wine=vial of wine
vials of lemonade=vial of lemonade
vials of urine=vial of urine
crowns=crown
silver brooches=silver brooch
gold nuggets=gold nugget
blood orbs=blood orb
copper keys=copper key
parchments=parchment
red tomes=red tome
purple tomes=purple tome
grey tomes=grey tome
green tomes=green tome
blue tomes=blue tome
birdcages=birdcage
christmas trees=christmas tree
piggy banks=piggy bank
cups=cup
jugs=jug
large amphoras=large amphora
vases=vase
drums=drum
barrels=barrel
pumpkinheads=pumpkinhead
durty capes=dirty cape
big bones=big bone
boxes=box
voodoo dolls=voodoo doll
voodoo dolls=voodoo doll
tusks=tusk
twigs=twigs
snakebite rods=snakebite rod
wands of vortex=wand of vortex
wands of plague=wand of plague
wands of cosmic energy=wand of cosmic energy
volcanic rods=volcanic rod
tempest rods=tempest rod
panda teddies=panda teddy
silver keys=silver key
crystal keys=crystal key
cookbooks=cookbook
amazon armors=amazon armor
wooden chairs=wooden chair
chests of drawers=chest of drawers
indoor plants=indoor plant
troughs=trough
large trunks=large trunk
harps=harp
pianos=piano
table lamps=table lamp
rocking horses=rocking horse
tusk chairs=tusk chair
bamboo tables=bamboo table
telescopes=telescope
green cushioned chairs=green cushioned chair
rocking chairs=rocking chair
small tables=small table
statues=statue
water pipes=water pipe
square tables=square table
sofa chairs=sofa chair
big tables=big table
small round tables=small round table
minotaur statues=minotaur statue
goblin statues=goblin statue
pendulum clocks=pendulum clock
cuckoo clocks=cuckoo clock
globes=globe
red cushioned chairs=red cushioned chair
lockers=locker
dressers=dresser
ancient tiaras=ancient tiara
old parchments=old parchment
carved stone tables=carved stone table
tusk tables=tusk table
ivory chairs=ivory chair
gemmed lamps=gemmed lamp
roc feathers=roc feather
worn leather boots=worn leather boots
spectral dresses=spectral dress
ball gowns=ball gown
sheets of paper=sheet of paper
spectral stones=spectral stone
broken bottles=broken bottle
broken swords=broken sword
burnt scrolls=burnt scroll
some leaves=some leaves
old twigs=old twig
remains of a fish=remains of a fish
torn books=torn book
amazon helmets=amazon helmet
books=book
fire bugs=fire bug
pirate voodoo dolls=pirate voodoo doll
ape fur=ape fur
sniper gloves=sniper gloves
vials of fruit juice=vial of fruit juice
atlases=atlas
dragha's spellbooks=dragha's spellbook
armor racks=armor rack
weapon racks=weapon rack
blue pieces of cloth=blue piece of cloth
green pieces of cloth=green piece of cloth
mangos=mango
vials of coconut milk=vial of coconut milk
cornucopias=cornucopia
thick trunks=thick trunk
cups=cup
mysterious voodoo skulls=mysterious voodoo skull
dragon scale helmets=dragon scale helmet
books=book
lottery tickets=lottery ticket
used candlesticks=used candlestick
boxes=box
staffs=staff
stuffed dragons=stuffed dragon
cakes=cake
ovens=oven
party cakes=party cake
cakes=cake
medals of honour=medal of honour
worn soft boots=worn soft boots
stones=stone
the carrot of doom=the carrot of doom
the horn of sundering=the horn of sundering
maps=map
maps=map
coloured eggs=coloured egg
coloured eggs=coloured egg
coloured eggs=coloured egg
coloured eggs=coloured egg
coloured eggs=coloured egg
amber staffs=amber staff
shards=shard
blacksteel swords=blacksteel sword
mystic blades=mystic blade
heroic axes=heroic axe
northern pikes=northern pike
taurus maces=taurus mace
pair of earmuffs=pair of earmuffs
presents=present
war axes=war axe
resonance crystals=resonance crystal
ice mammoths=ice mammoth
golden figurines=golden figurine
abyss hammers=abyss hammer
relic swords=relic sword
strong mana potions=strong mana potion
strong health potions=strong health potion
giant shimmering pearls=giant shimmering pearl
terra hoods=terra hood
stamped letters=stamped letter
empty potion flasks=empty potion flask
small enchanted sapphires=small enchanted sapphire
small enchanted emeralds=small enchanted emerald
small enchanted rubies=small enchanted ruby
small enchanted amethysts=small enchanted amethyst
balls on chains=ball on chains
presents=present
nature magic spellbooks=nature magic spellbook
sapphire amulets=sapphire amulet
flower pots=flower pot
withered plants=withered plant
the witches' grimoires=the witches' grimoire
solar axes=solar axe
oracle figurines=oracle figurine
bricklayers' kits=bricklayers' kit
chimneys=chimney
branches=branch
your student books=your student book
beach backpacks=beach backpack
beach bags=beach bag
yellow pillows=yellow pillow
ornamented axes=ornamented axe
unholy books=unholy book
abaci=abacus
energy spike swords=energy spike sword
small bamboo shelves=small bamboo shelf
bamboo shelves=bamboo shelf
documents=document
tortoise eggs from nargor=tortoise egg from nargor
dracoyle statues=dracoyle statue
slingshots=slingshot
divine plates=divine plate
blood crystals=blood crystal
julius' maps=julius' map
worn firewalker boots=worn firewalker boots
ornamented stone tables=ornamented stone table
enigmatic voodoo skulls=enigmatic voodoo skull
rusty armors=rusty armor
rusty armors=rusty armor
rusty armors=rusty armor
havoc blades=havoc blade
rusty legs=rusty legs
rusty legs=rusty legs
rusty legs=rusty legs
empty potion flasks=empty potion flask
empty potion flasks=empty potion flask
parts of a jester doll=part of a jester doll
parts of a jester doll=part of a jester doll
parts of a jester doll=part of a jester doll
parts of a jester doll=part of a jester doll
pigeon trophies=pigeon trophy
magical torches=magical torch
deep crystals=deep crystal
potatoes=potato
the rain coat=the rain coat
prison cell keys=prison cell key
golden fafnar trophies=golden fafnar trophy
silver fafnar trophies=silver fafnar trophy
northern stars=northern star
hellspawn tails=hellspawn tail
essences of a bad dream=essence of a bad dream
dark rosaries=dark rosary
mammoth tusks=mammoth tusk
tomes of knowledge=tome of knowledge
frosty hearts=frosty heart
gauze bandages=gauze bandage
winter wolf furs=winter wolf fur
red lanterns=red lantern
cyclopes toe=cyclops toe
sabreteeth=sabretooth
terramite eggs=terramite eggs
wailing widow's necklaces=wailing widow's necklace
sai=sai
dragon thrones=dragon throne
dragon statues=dragon statue
flasks of extra greasy oil=flask of extra greasy oil
snowman packages=snowman package
pieces of marble rock=piece of marble rock
treasure chests=treasure chest
water pipes=water pipe
broken shamanic staffs=broken shamanic staff
colourful feathers=colourful feather
geomancer's staffs=geomancer's staff
goblin ears=goblin ear
dragonfruits=dragonfruit
pineapples=pineapple
demonic candy balls=demonic candy ball
spiritual charms=spiritual charm
shields of corruption=shield of corruption
gamemaster dolls=gamemaster doll
stones of wisdom=stone of wisdom
solitude charms=solitude charm
scum bags=scum bag
bunches of winterberries=bunch of winterberries
rotten witches' cauldron seeds=rotten witches' cauldron seed
